##############################################
#####               ###########            ###
##### ### #####        ########## #          #
##                        ##                 #
## ## ###  #####    ##                       #
## ## ### #####                              #
##         ####                              #
## #  ### #   #                              #
##          #       #                        #
##                                       #   #
## ##   # # #                                #
## ##   # # ##                          ##   #
## ##   # # ## ###                       #   #
##      # #                          #   #   #
##      # #                                  #
## ## # # # ## #####       ### #     ##  #   #
##             ########                     @#
##############################################
